6
11
0 200  20 220  40 200  60 220   80 200  100 220  120 200  140 220  160 200  180 220 200 200
11
0 210  20 190  40 210  60 190  80 210  100 190  120 210  140 190  160 210  180 190  200 210
11
0 160  20 180  40 160  60 180   80 160  100 180  120 160  140 180  160 160  180 180  200 160
11
0 170  20 150  40 170  60 150  80 170  100 150  120 170  140 150  160 170  180 150  200 170
11
0 130  20 150  40 130  60 150   80 130  100 150  120 130  140 150  160 130  180 150  200 130
11
0 120  20 140  40 120  60 140  80 120  100 140  120 120  140 140  160 120  180 140  200 120
